BossGbln=Boss Goblin 
BlueGbln=Blue Goblin
Hobgobln=Hobgoblin
GooTitan=Goo Titan
Weretigr=Weretiger
ProtoBot=Prototype Bot
ArmorBot=Armor Bot
HyperBot=Hyper Bot
TankBot=Medical Bot
DeathBot=Eliminator
Berserkr=Berserker
MultiBot=Reflector
NutTroop=Nut Trooper
NutArchr=Nut Archer
RankWeed=Rank Weed
PainWeed=Pain Weed
FireSlug=Fire Slug
HugeSlug=Huge Slug
LizardMn=Lizard Man
BloodBat=Blood Bat
BoltMage=Bolt Mage
BoltArch=Bolt Archer
BarbBulb=Barbed Bulb
BombSeed=Bomb Seed
D.Zombie=Dragon Zombie
ZombieDr=Zombie Doctor
GntRoach=Giant Roach
Dragnfly=Dragonfly
ToxicFly=Toxic Fly
GntCrab=Giant Crab
BoltLord=Bolt Lord
KingToad=King Toad
PipeBomb=Pipe Bomb
GntOrc=Giant Orc
VileWeed=Vile Weed
ToxicMan=Toxic Man
Nitemare=Nightmare
RedDrake=Red Drake
IceDrake=Ice Drake
FoulWeed=Foul Weed
Plant42=Plant #42
D.Lord=Dragon Lord
NightBat=Night Bat